0101000|1001000|0101000|1100000|1101100|1000000
0111000|1111010|1010000|0100000|1111000|1001000
0111000|1111000|1000000|0101000|1111000|1011000
0111000|1111000|1101000|1011000|0111000|1010010
0111010|1111000|1111000|1110000|1011000|0000000
0110000|1010001|0110000|1100000|1110000|1000000
