0101000|1101000|1100000|1101000|1001000|0001000
0111000|1011000|0100001|1111010|1111000|1011000
0111010|1111000|1000000|0111000|1110000|1011000
0110000|1111000|1101000|1010000|0001000|0011000
0101000|1010000|0111000|1100000|1011000|0011000
0110000|1100000|1010010|0100000|1110000|1010100
