0101000|1100000|1101000|1001000|0101011|1001010
0111000|1101000|1011000|0010000|0111000|1011000
0011000|0111000|1111000|1001000|0110000|1011000
0111000|1111000|1011000|0110000|1101000|1010000
0111000|1011000|0111000|1001000|0111000|1001000
0110010|1110000|1010100|0110000|1110000|1010000
