0101000|1101000|1001000|0101000|1001010
0111000|1011000|0110100|1010000|0011000
0011000|0110000|1101000|1100001|1011000
0111000|1000000|0111000|1100010|1011000
0010010|0100000|1110000|1100000|1010000
