0101000|1000000|0101000|1000000|0100000|1101000|1000010
0110000|1001000|0010000|0001000|0101000|1110000|1000000
0101000|1111010|1101000|1111000|1011000|0001001|0001000
0111000|1010000|0111000|1111000|1110000|1111000|1011000
0111000|1100000|1010000|0110000|1001000|0110000|1011000
0111000|1001000|0101000|1001000|0110000|1001000|0011010
0110100|1110000|1010000|0110000|1100000|1110000|1010000
