0101000|1101000|1101000|1101000|1100000|1001000
0010000|0110000|1110000|1111000|1001000|0011100
0100000|1101000|1101000|1011000|0111000|1011000
0001010|0011000|0111000|1111000|1111000|1011000
0110000|1111000|1111000|1111000|1111000|1011000
0100010|1110001|1110000|1010010|0110000|1010000
