0100000|1000000|0100000|1100000|1001000|0001000
0000000|0001000|0001000|0100000|1111000|1010010
0100000|1110000|1110000|1000000|0110010|1001001
0001000|0100000|1100000|1000000|0100000|1011000
0110100|1100000|1101000|1100000|1100000|1011000
0000000|0100000|1110010|1000000|0100000|1010000
