0101000|1101000|1001010|0001000|0000000
0111100|1110000|1011000|0111000|1001000
0111000|1101000|1111000|1111000|1010000
0110001|1010000|0111000|1011000|0000000
0100000|1100000|1010010|0110000|1000010
