0101100|1101000|1101000|1000000|0101000|1100000|1000000
0111000|1010000|0010000|0100000|1111000|1100000|1001000
0111000|1101010|1000000|0000000|0110000|1000000|0011000
0011000|0011000|0101000|1101000|1100000|1000000|0011000
0110000|1110000|1011000|0010000|0100000|1100000|1010000
0100000|1101000|1110000|1101000|1101000|1100010|1001010
0100000|1110000|1100000|1010000|0010000|0000000|0010001
