0101100|1001000|0100000|1101000|1001010
0111000|1110000|1100000|1111000|1011000
0011000|0100000|1101000|1111000|1011000
0111000|1101000|1110000|1110000|1011000
0110000|1110010|1000001|0100000|1010010
