0101000|1100000|1001000|0000000|0001010
0111010|1101001|1111000|1101000|1011000
0111000|1011000|0110000|1111000|1011000
0111000|1111000|1001000|0111000|1011000
0110010|1110000|1010000|0010000|0010100
