0101000|1101100|1000000|0101000|1000000|0000000
0111000|1111000|1101000|1111000|1100000|1001000
0110000|1111000|1011000|0011000|0001000|0011010
0100000|1010001|0110000|1111000|1111000|1010000
0001000|0000000|0101000|1111000|1111000|1000000
0010000|0100010|1110000|1010000|0110010|1000000
