0101010|1001000|0100000|1101000|1000000|0001000
0011000|0110010|1101000|1011000|0101000|1010000
0110000|1101000|1110000|1011000|0111000|1001000
0100100|1110000|1000000|0010000|0111000|1010000
0001000|0000000|0101000|1101000|1011000|0001001
0010000|0000000|0110000|1110000|1010010|0010000
