0000000|0101000|1101000|1101000|1001000|0001100
0101000|1111010|1011000|0111001|1011000|0011000
0011000|0110000|1110000|1011000|0111000|1010000
0011000|0000000|0001000|0011000|0110000|1001000
0011000|0101010|1111000|1111000|1101000|1011000
0110000|1110000|1110000|1110000|1010010|0010000
