0001000|0101000|1101000|1101000|1101000|1000000
0111000|1110000|1011001|0111000|1111000|1001000
0111010|1100000|1010000|0111000|1111010|1011000
0111000|1001000|0100000|1010000|0110000|1010000
0011000|0111000|1100000|1001000|0101000|1001000
0110010|1110000|1000000|0110000|1010000|0010100
