0101000|1101010|1001000|0100000|1001010
0111000|1111000|1111000|1000001|0011000
0011000|0110000|1111000|1001000|0011000
0110000|1100000|1011000|0011000|0011000
0100100|1100000|1110000|1110000|1010010
