0101001|1001000|0101010|1000000|0101000|1000000
0111000|1111000|1011000|0101000|1110000|1001000
0110010|1111000|1111000|1011000|0100000|1011000
0001000|0110000|1111000|1110000|1000000|0011010
0111000|1000000|0011000|0001000|0100000|1010000
0110000|1000000|0110000|1010100|0100000|1000000
