0001000|0101000|1101000|1101000|1001000|0001010|0001000
0010000|0111000|1111000|1110000|1111000|1110000|1011011
0101000|1111000|1011000|0101000|1110000|1101000|1011000
0111000|1111000|1010000|0111000|1101000|1010000|0011000
0111100|1111000|1001000|0111000|1111000|1001000|0011000
0111000|1111000|1110000|1111000|1111000|1111000|1011000
0110010|1110000|1100000|1110000|1110000|1010000|0010000
