0101000|1000010|0001000|0100000|1001100
0110000|1001000|0111000|1101000|1011000
0101000|1111000|1110000|1110000|1010000
0110000|1110000|1001000|0100000|1001000
0100010|1100000|1110001|1100000|1010010
