0000000|0101010|1001000|0001000|0000000|0001000
0101010|1011000|0111000|1011000|0101000|1011000
0011000|0111000|1010000|0010000|0011000|0010010
0110000|1111000|1001000|0101000|1110000|1001000
0101000|1011000|0111000|1011000|0100000|1010000
0010001|0010000|0110000|1110000|1000100|0000000
