0101000|1100000|1101000|1001000|0001100
0110000|1101000|1010000|0011001|0011000
0000000|0111000|1100000|1111000|1011000
0101000|1111000|1001010|0111000|1011000
0110000|1110010|1110010|1110000|1010000
