0101100|1101000|1101000|1101010|1001000
0111000|1110000|1011000|0110000|1011000
0111000|1101000|1111000|1101000|1011001
0111000|1111000|1010000|0111000|1011000
0110010|1110000|1000000|0010000|0010010
