0100000|1101000|1100000|1101000|1101000|1001000
0000000|0111010|1100000|1111000|1110010|1011000
0101000|1010001|0001000|0011000|0101000|1011000
0111000|1101000|1110000|1111000|1010000|0011000
0111000|1110000|1101000|1011000|0101000|1011000
0110000|1100010|1010000|0110000|1110000|1010100
