0101010|1101000|1101000|1101000|1101000|1001000
0011000|0110000|1011000|0111100|1111000|1011000
0111000|1101000|1111000|1111000|1111000|1010000
0011000|0111000|1111000|1111000|1111000|1001000
0111000|1011000|0111000|1110000|1111000|1010000
0110011|1110000|1110000|1100000|1110000|1000010
