0101010|1101000|1000000|0000000|0001000
0111000|1011000|0000000|0101000|1010000
0111000|1111000|1001000|0110000|1000010
0111010|1010000|0111000|1101000|1000001
0010100|0100000|1010000|0110000|1000000
