0101010|1001000|0100000|1100001|1101000|1101000|1000010
0110000|1111000|1101000|1100000|1011000|0010000|0001000
0001000|0111000|1010000|0001000|0011000|0100000|1010000
0110000|1111000|1101000|1111000|1110000|1101000|1001000
0001000|0110000|1111000|1110000|1100000|1110000|1010000
0111000|1100000|1110000|1101010|1101000|1100000|1001000
0110000|1000000|0100000|1110000|1110000|1000000|0010100
