0101100|1101000|1101000|1001000|0001010
0011000|0011000|0111000|1111000|1011000
0011000|0110000|1111000|1010000|0011001
0011000|0001000|0111000|1001000|0010000
0110000|1110010|1110000|1110000|1000010
