0101000|1100000|1101000|1001001|0101000|1000000
0110010|1101000|1010000|0111000|1111000|1000000
0101000|1111000|1100000|1111000|1110000|1001000
0111000|1010010|0101000|1111000|1101000|1010010
0010000|0100000|1110000|1111000|1010000|0001000
0000000|0100000|1100000|1110000|1100000|1010100
