0101100|1101000|1100000|1101000|1100000|1000000
0111000|1111000|1101000|1111000|1101000|1000000
0110010|1111000|1011000|0010000|0111000|1001000
0100000|1110000|1111000|1101000|1111000|1011010
0101000|1000000|0111000|1110000|1111011|1011000
0110000|1000000|0110000|1100000|1010000|0010000
