0001000|0101100|1000000|0001000|0101000|1001000
0010000|0111000|1101000|1111000|1110000|1011010
0100000|1111000|1010000|0110000|1101000|1010000
0101000|1111000|1000000|0101000|1111000|1001000
0110000|1111000|1101000|1110000|1111000|1011000
0100010|1110000|1010000|0100001|1010010|0010000
