0100000|1101000|1001000|0100000|1000000|0001100
0101000|1110000|1111000|1100000|1101000|1011000
0110000|1000000|0010000|0101000|1110000|1011010
0001000|0001000|0001010|0011000|0100000|1011000
0111000|1010000|0011000|0111000|1100000|1011000
0010000|0100010|1110000|1110001|1100000|1010000
