0100000|1101000|1101010|1101000|1001000
0101000|1111000|1110000|1111000|1011000
0010000|0111000|1001001|0111000|1011000
0101000|1111000|1011010|0010000|0010010
0110100|1110000|1010000|0100000|1000000
