0100010|1101000|1101010|1101000|1100000|1101000|1001010
0101000|1011000|0011000|0111000|1000000|0111001|1011000
0111000|1011000|0011000|0111000|1101000|1110000|1011000
0111000|1111000|1111000|1110000|1110000|1100000|1011000
0111000|1111000|1011000|0001000|0101000|1101000|1011000
0111000|1011000|0111000|1111000|1111000|1011000|0011000
0110100|1110000|1110000|1110000|1110000|1110000|1010000
