0101010|1101000|1001000|0101000|1000000
0111000|1111000|1010000|0111001|1001000
0011000|0010000|0101000|1111010|1010000
0111010|1100000|1110000|1111000|1001000
0110000|1100000|1100100|1110000|1010000
