0001100|0101000|1100000|1100010|1101000|1001000|0001000
0110000|1111000|1000000|0100000|1111000|1110000|1011000
0100000|1111000|1001000|0101000|1011000|0101000|1011000
0101000|1011000|0011000|0110000|1111000|1111000|1011000
0011000|0011000|0010000|0100000|1011000|0011000|0011000
0111010|1111000|1001000|0001000|0011001|0110000|1011000
0010000|0010000|0110000|1010000|0110000|1000000|0010010
