0001010|0001000|0001001|0001010|0001000
0111000|1110000|1111000|1111000|1011000
0011000|0001000|0011000|0110000|1011000
0110000|1110000|1111000|1101000|1010000
0100100|1100000|1110000|1110000|1000010
