0101000|1100000|1101000|1001000|0101000|1101000|1001010
0110010|1101000|1111000|1011000|0111000|1110000|1011000
0101000|1111000|1110000|1110000|1111000|1101000|1011000
0111000|1111000|1001000|0101000|1011000|0010000|0011001
0111000|1111000|1111000|1111000|1111000|1001000|0011000
0111000|1111000|1111000|1111000|1011010|0111000|1010000
0110100|1110000|1010000|0010000|0110000|1110000|1000000
