0101000|1001000|0101000|1100000|1000000
0011000|0010000|0010000|0101000|1001100
0011010|0101000|1101001|1110000|1011010
0010000|0111000|1010000|0100000|1011000
0000000|0110000|1100010|1100000|1010000
