0101010|1100000|1101000|1101000|1101001|1001000
0110000|1101000|1111000|1111000|1110000|1011000
0101000|1111000|1110000|1111000|1100000|1010000
0111000|1111000|1000000|0111000|1001000|0001000
0111100|1111000|1101000|1011000|0111000|1011000
0110000|1010010|0110000|1110000|1110000|1010010
