0101000|1101100|1101000|1001000|0001010
0010000|0111000|1110000|1111000|1011000
0100000|1011000|0101000|1111000|1011000
0101010|1111000|1111000|1110010|1011001
0110000|1110000|1010000|0100000|1010000
