0101010|1001000|0101001|1101000|1000010
0110000|1110000|1010000|0111000|1001000
0101000|1100000|1101000|1110000|1011000
0011000|0100000|1011000|0101000|1011000
0110000|1100010|1010000|0010000|0010100
