0101000|1100000|1000000|0100000|1101000|1001000
0111000|1101010|1000000|0000000|0110100|1011000
0111000|1110000|1000000|0001000|0101000|1011000
0111000|1101000|1000000|0110000|1111000|1011000
0010010|0011000|0101000|1000000|0110000|1011000
0100000|1110000|1010010|0000000|0100001|1010000
