0101100|1001000|0001000|0101000|1000000|0000000
0111000|1011000|0010000|0110000|1100000|1001000
0111000|1111000|1101000|1000000|0100000|1010000
0111000|1010000|0111001|1001000|0001000|0001000
0111000|1100000|1010000|0010010|0010000|0010000
0110000|1100000|1000010|0000000|0100010|1000000
