0101000|1001000|0101000|1101000|1000010
0010100|0111000|1111000|1111000|1000000
0100000|1111000|1010000|0110000|1001000
0101000|1111000|1001000|0101000|1011000
0110010|1010000|0110000|1110001|1010010
