0001000|0101000|1101010|1100000|1000000|0001000
0011000|0111000|1011000|0101000|1101000|1011010
0111000|1011000|0110001|1110000|1111000|1010000
0110000|1011000|0100000|1001000|0011000|0001000
0000000|0011000|0001000|0011000|0010000|0011000
0000000|0010100|0110000|1010000|0100000|1010010
