0101000|1000000|0101000|1000000|0001100
0011000|0101000|1010000|0101010|1011000
0010000|0111010|1100000|1110000|1011000
0101000|1011000|0101000|1100001|1010000
0110000|1110010|1110000|1100000|1000000
