0100000|1101000|1001010|0101000|1000000|0001000
0100001|1111010|1111000|1011000|0101000|1011000
0100000|1110000|1110000|1110000|1111000|1010000
0100000|1101000|1100000|1100000|1111000|1001100
0100000|1110000|1001000|0001000|0011000|0011000
0000000|0100000|1010000|0110000|1110010|1010000
