0001000|0101010|1000000|0101000|1001000|0001000
0110000|1111000|1100000|1111000|1011000|0011100
0101000|1110000|1001000|0111000|1111000|1010000
0111001|1100000|1111000|1111000|1111000|1001000
0110010|1100000|1110000|1010000|0111000|1011000
0100000|1100000|1100000|1000000|0010000|0010010
