0101000|1000000|0101000|1000000|0001100
0011000|0001000|0011010|0101000|1011000
0111001|1111000|1111000|1111000|1011000
0111010|1111000|1111000|1111000|1011000
0010000|0110000|1110010|1110000|1010000
