0001100|0101000|1101000|1101010|1000000|0000000
0110000|1011000|0111000|1111000|1101000|1001000
0101000|1110000|1110000|1111000|1111000|1010000
0111000|1101000|1101000|1111000|1110000|1001000
0111000|1110000|1111000|1111000|1001000|0011010
0010010|0100000|1110001|1010000|0110000|1010000
