0001100|0100000|1100000|1100000|1000000
0111000|1101000|1101000|1101000|1001010
0110000|1111000|1110000|1111000|1011000
0101000|1011000|0101000|1111000|1011000
0110010|1110000|1110001|1110000|1010010
