0100000|1001010|0101000|1100000|1001000
0100000|1110000|1011000|0101001|1011000
0101000|1101000|1111000|1111010|1011010
0111000|1111000|1110000|1111000|1011000
0110100|1110000|1100000|1010000|0010000
