0100000|1101000|1001000|0000000|0001100
0001000|0110000|1111000|1101000|1010000
0111000|1001000|0111010|1110000|1001000
0110000|1011000|0111000|1100000|1011000
0100010|1110001|1110000|1100010|1010000
