0001000|0100011|1101000|1000000|0001000
0111010|1101000|1110000|1100000|1011000
0010000|0011000|0101000|1101000|1011000
0101000|1111000|1010000|0111000|1011100
0110000|1110010|1100000|1110000|1010000
