0001010|0100000|1100000|1001000|0101000|1001100
0111000|1101000|1101000|1010000|0111000|1011000
0110000|1111000|1110000|1101000|1111000|1010000
0000000|0110000|1101000|1111000|1111000|1001000
0001010|0101001|1111000|1111000|1111000|1011000
0110000|1110000|1110000|1110000|1110010|1010000
