0001000|0101000|1100000|1101000|1001010
0010000|0011000|0101000|1111010|1011000
0101000|1011000|0111000|1011000|0011100
0011000|0111000|1111000|1110000|1010000
0110011|1010000|0110000|1100000|1000000
