0101000|1101000|1100000|1001000|0101000|1001000
0111000|1010000|0000000|0111000|1011000|0010010
0110010|1100000|1001000|0011000|0111000|1000010
0101000|1000000|0111000|1111000|1110000|1001000
0111000|1100000|1010100|0011000|0000000|0010000
0110000|1000000|0100000|1110000|1100001|1000000
