0101000|1101100|1101000|1100000|1001000
0011000|0010000|0111000|1100000|1011000
0111000|1001000|0111000|1000000|0011000
0110010|1111000|1111000|1001000|0010001
0100000|1110000|1110010|1110000|1000010
