0001000|0101000|1101000|1101000|1100000|1001010
0010000|0110000|1111000|1110000|1001000|0010001
0101010|1101000|1111000|1001000|0111000|1001010
0010000|0111000|1011000|0110000|1111000|1011000
0101000|1111100|1011000|0101000|1110000|1011000
0010000|0010000|0010000|0010000|0100000|1010000
