0001000|0100000|1000000|0101000|1101000|1001010
0111000|1100100|1101000|1111000|1110000|1010000
0110000|1101000|1111000|1011000|0100000|1000000
0101000|1111000|1011000|0011000|0101000|1001000
0111000|1111000|1111000|1110000|1111000|1011000
0010010|0010000|0110000|1000000|0110000|1010011
