0101000|1101000|1001000|0100001|1001000
0110100|1111000|1010000|0101000|1010000
0100000|1111010|1101000|1111000|1001000
0100000|1111000|1110000|1110000|1011000
0000000|0110000|1100010|1100000|1010010
