0101100|1101000|1001000|0000000|0101000|1000000
0111000|1111000|1011000|0101000|1111000|1001000
0111000|1111010|1010000|0010000|0010000|0010000
0111000|1111000|1001000|0001000|0001000|0001010
0111000|1111000|1111000|1111000|1011000|0011000
0010010|0110000|1110000|1010001|0110000|1010000
