0101100|1100000|1001000|0000000|0001000
0010000|0001000|0111000|1001000|0011010
0101000|1111000|1111000|1110000|1010000
0111000|1111000|1111000|1001000|0000000
0110010|1110000|1110001|1110000|1000010
