0100010|1101000|1101001|1101000|1001010
0001000|0111000|1111000|1111000|1010000
0010000|0111000|1111000|1111000|1001000
0001000|0110000|1110000|1111000|1011000
0010000|0100010|1100000|1010000|0010100
