0101000|1101000|1101000|1100000|1000001|0101000|1001010
0110000|1011000|0110000|1101000|1101000|1111000|1011000
0101000|1110000|1101000|1011000|0010000|0010000|0010000
0010000|0101000|1111000|1111000|1101000|1101000|1001000
0001000|0011000|0111000|1111000|1111000|1010000|0010000
0111100|1111000|1011000|0011000|0111000|1101000|1000010
0010000|0110000|1010000|0110000|1110000|1110010|1000000
