0101100|1100000|1101000|1101000|1000010
0110000|1101000|1111000|1011000|0000000
0101000|1111000|1011000|0111000|1000000
0111000|1111000|1111000|1011010|0001000
0110000|1010000|0110000|1110011|1010000
