0101010|1101000|1101000|1101000|1001100
0110000|1110000|1010000|0110000|1011000
0101001|1001000|0101000|1101000|1011000
0111000|1111000|1111000|1010000|0011010
0010010|0110000|1110000|1000000|0010000
