0100000|1101000|1101000|1101000|1101000|1100000|1001100
0100010|1011000|0111000|1111000|1011000|0101000|1011000
0001000|0111000|1111000|1111000|1111010|1011000|0011000
0011000|0110000|1111000|1011000|0111000|1011000|0011000
0110000|1000000|0111000|1110000|1111000|1111000|1010000
0101000|1001000|0111000|1000000|0110000|1111000|1001000
0110000|1110000|1110001|1000010|0100000|1110000|1010000
