0100100|1101000|1101000|1100000|1001000
0000000|0111000|1111000|1000000|0011010
0100000|1011000|0110010|1100000|1011000
0001000|0110000|1100000|1001000|0011000
0110000|1100000|1000000|0110001|1010010
