0001000|0100000|1101000|1101000|1001000|0001010
0111000|1101010|1010000|0111000|1110000|1011000
0011000|0110000|1100000|1011000|0101001|1011000
0111000|1101000|1100000|1110000|1110000|1011000
0010000|0110000|1001000|0001000|0101000|1010000
0100100|1100000|1010000|0110000|1110010|1000000
