0101010|1101000|1100000|1101000|1001100
0111000|1111000|1000000|0011000|0010000
0111001|1111000|1000000|0111000|1001000
0111000|1110000|1101000|1011000|0011000
0110000|1000010|0110000|1010000|0010010
