0101000|1101000|1100010|1101000|1101000|1000000
0111000|1111000|1100000|1111000|1011000|0001001
0011000|0111000|1100000|1111000|1111000|1011000
0111100|1010000|0101000|1111000|1111000|1011010
0110000|1000000|0011000|0111000|1011000|0011000
0100000|1100000|1110000|1110010|1110000|1010000
