0101000|1100000|1101010|1100000|1101000|1001000
0110000|1100000|1110000|1100000|1110000|1011010
0101000|1101000|1101000|1101000|1101000|1010000
0110001|1011000|0011000|0111000|1111000|1001000
0101000|1010000|0111000|1110000|1011000|0011000
0110000|1100000|1010010|0100000|1010000|0010100
