0101010|1101011|1101000|1101000|1000000
0110000|1111000|1111000|1111000|1001000
0100000|1111000|1111000|1111000|1011000
0101000|1111010|1111000|1111000|1011000
0110000|1110000|1110000|1010000|0010100
