0101000|1101010|1101000|1101000|1001010
0010001|0111000|1111000|1111000|1011000
0001000|0111000|1111000|1011000|0011000
0111000|1111000|1110000|1111000|1011000
0110000|1110000|1000010|0110000|1010100
