0101000|1100000|1101000|1001000|0100000|1100000|1001000
0110000|1100000|1111000|1111000|1101000|1100000|1011010
0101000|1101000|1011000|0110100|1111000|1101000|1010000
0111000|1010000|0111000|1101000|1111000|1110000|1000000
0111000|1101000|1111000|1011000|0111000|1100000|1001000
0111000|1110010|1110000|1011000|0110000|1100000|1010000
0110001|1100010|1100000|1110000|1000000|0000000|0000000
