0001010|0100000|1000000|0000000|0101000|1001100
0111000|1001000|0000000|0101000|1011000|0011000
0111000|1111000|1101000|1111000|1110000|1010000
0011010|0111000|1010000|0110000|1100000|1001000
0011000|0010001|0001000|0101000|1100000|1011000
0110000|1000000|0010000|0010000|0000000|0010010
