0001100|0001000|0101000|1001000|0100000|1001000
0111010|1110000|1111000|1011000|0001000|0010000
0111000|1100010|1111000|1110000|1011000|0001000
0110000|1100000|1110000|1101000|1011000|0011000
0100000|1101000|1100000|1011000|0111001|1011000
0100000|1110000|1000000|0110000|1110000|1010010
