0001000|0000000|0101000|1001000|0100000|1100000|1001000
0111000|1000010|0110000|1111000|1101000|1100010|1011000
0111000|1101000|1101000|1111000|1110010|1101000|1010000
0011000|0111000|1111000|1011000|0101000|1111000|1001000
0010000|0111000|1111000|1110000|1111000|1111000|1010000
0101000|1011000|0011000|0100000|1011000|0110000|1001000
0010000|0110100|1010000|0100000|1110001|1000000|0010000
