0101000|1101000|1101000|1001000|0001010
0011100|0011000|0010000|0110000|1011000
0110000|1111000|1001000|0101000|1011010
0101000|1111000|1111000|1111000|1010001
0110000|1110000|1110000|1110010|1000000
