0101000|1001000|0100000|1101000|1001010
0111000|1011000|0101001|1011000|0011000
0111000|1011000|0111000|1111000|1011010
0111000|1011100|0111000|1011000|0011000
0110000|1110000|1110000|1110010|1010000
