0100000|1101010|1101000|1001000|0001100
0101000|1110000|1111000|1111000|1011000
0111000|1101000|1111000|1011000|0011000
0011000|0111001|1011000|0111000|1011000
0010010|0110000|1110000|1110000|1010010
