0101010|1001000|0101000|1000000|0001100
0111000|1011000|0111000|1100000|1011000
0011001|0110000|1111000|1100000|1011000
0111000|1101000|1110000|1000000|0011010
0110010|1110000|1000000|0000000|0010000
