0101000|1001000|0000000|0100000|1001010|0101100|1001000
0010001|0011000|0001000|0101000|1111000|1111000|1011000
0101000|1111000|1010000|0111000|1010000|0111000|1011000
0011000|0110000|1101000|1011000|0100000|1111000|1011000
0110000|1001000|0110000|1010000|0000000|0111000|1011000
0100000|1111000|1100000|1101000|1101000|1011000|0011000
0100010|1110000|1100010|1110000|1110000|1110000|1010000
