0101000|1101000|1101000|1100000|1000000
0111010|1111000|1110000|1101000|1000100
0111010|1110000|1101000|1111000|1000000
0111001|1000000|0010000|0111000|1001000
0010000|0100000|1100000|1110000|1010010
