0101000|1001000|0101000|1000000|0001010
0111001|1110000|1011000|0101000|1011000
0011010|0100000|1111000|1011000|0010010
0111000|1001000|0110000|1110000|1001000
0010100|0110000|1100000|1100000|1010000
