0101000|1101000|1000000|0000000|0101000|1100010|1000000
0111000|1011000|0101000|1101000|1111000|1100100|1000000
0111000|1111000|1111000|1111000|1111000|1101000|1001000
0111000|1111000|1111000|1110000|1011000|0111000|1011000
0011000|0010000|0111000|1101010|1110000|1111000|1011000
0111000|1101000|1111000|1011000|0101000|1011000|0010000
0110011|1110000|1110000|1110000|1110000|1110000|1000000
