0100010|1100000|1100000|1100000|1101000|1001000|0001000
0101000|1101000|1000000|0101000|1111000|1111000|1011000
0111001|1011000|0101000|1111000|1111000|1111000|1010000
0111000|1110000|1110000|1111000|1111000|1110000|1001000
0111000|1101000|1100000|1111000|1110000|1101000|1010000
0011010|0111000|1101000|1111000|1000000|0011000|0001000
0110000|1110000|1110000|1110010|1100000|1010100|0010000
