0101000|1101000|1101000|1001010|0001000
0111000|1010000|0011010|0111000|1011000
0111100|1001000|0110000|1011001|0010000
0110000|1111000|1100000|1110000|1000000
0100000|1010010|0100000|1100000|1000000
