0001000|0101010|1101001|1101000|1001010
0010000|0110000|1011000|0111000|1011000
0101000|1101000|1111000|1011000|0011000
0110000|1110000|1111000|1111000|1011000
0100010|1100000|1110000|1010000|0010100
