0100100|1001000|0001000|0001000|0100000|1100000|1000000
0100000|1111000|1110000|1010000|0001000|0101000|1001010
0001000|0111000|1101000|1001000|0111000|1111000|1011000
0111000|1111000|1011000|0111000|1111000|1110000|1010000
0110000|1110010|1111000|1011000|0110000|1001000|0001000
0101000|1101000|1110000|1110000|1101001|1011000|0011000
0110000|1110000|1100000|1100000|1110000|1110000|1010010
