0100010|1101000|1101000|1001001|0000000|0000000
0100010|1111000|1011000|0111000|1101000|1001000
0100000|1011000|0111000|1011000|0111000|1010000
0101000|1011000|0110100|1111000|1111000|1000000
0110000|1111000|1101000|1011000|0011000|0000000
0100000|1110000|1010000|0110010|1010000|0000000
