0101010|1101011|1101000|1101000|1101000|1001000
0111000|1111000|1111000|1111000|1011000|0011000
0110000|1011000|0111000|1011000|0110000|1011000
0001000|0111000|1010000|0110000|1101000|1011100
0110000|1110000|1001000|0001000|0111000|1011000
0100000|1000000|0010000|0110000|1110000|1010010
