0101010|1101000|1001000|0001000|0100000|1001000
0111000|1111100|1110000|1011000|0101000|1011000
0011000|0110000|1100000|1110000|1011000|0011000
0111000|1101000|1100000|1000000|0110000|1011000
0011000|0111000|1100000|1101000|1000000|0011011
0110000|1110000|1000000|0110000|1000000|0010010
