0101100|1000000|0101000|1100000|1101000|1001010
0111000|1101000|1110000|1001000|0111000|1011000
0010000|0110000|1101000|1011000|0111000|1010000
0100000|1101000|1111000|1011000|0011001|0001000
0101000|1111000|1010000|0111000|1110000|1011000
0110000|1010000|0100010|1110000|1100010|1010000
