0101010|1101000|1101000|1101000|1000100
0011000|0110000|1110000|1011000|0001000
0110001|1101000|1101000|1111000|1011000
0101000|1111000|1111000|1110000|1011010
0110010|1110000|1110000|1100000|1010000
