0100010|1101000|1101000|1101010|1001000
0101000|1111000|1111000|1111000|1011000
0111001|1011000|0111000|1111000|1011000
0111000|1111000|1110000|1110000|1011000
0110010|1110000|1100000|1000000|0010100
