0100100|1101000|1101000|1101000|1001010
0101000|1111000|1111000|1111000|1011000
0111000|1111000|1110000|1111000|1010001
0111010|1111000|1101000|1111000|1001000
0110000|1110000|1010000|0110000|1010010
