0100000|1101000|1101000|1001000|0101010|1001001
0101000|1111000|1111000|1111000|1111010|1010000
0110000|1111000|1111000|1111000|1111000|1001000
0101000|1111000|1011000|0111000|1111000|1011000
0111100|1111000|1111000|1111000|1110000|1011000
0110000|1110010|1110000|1110000|1100000|1010000
