0100000|1001000|0001001|0101000|1001010
0001010|0011000|0111000|1011000|0011000
0111000|1111000|1110000|1111000|1011000
0111000|1011000|0001000|0111000|1011000
0010010|0010000|0110000|1110000|1010100
