0001001|0101010|1001000|0000000|0100000|1001000
0111000|1110000|1110000|1101000|1101000|1011000
0010000|0100000|1001000|0110000|1110100|1011000
0101000|1001000|0010000|0101000|1101000|1011000
0111000|1010000|0001000|0110000|1111000|1011000
0010010|0100000|1110000|1100000|1110000|1010010
