0101011|1101000|1100000|1101000|1000000|0101010|1000000
0011000|0110000|1001000|0011000|0100000|1111000|1001000
0110000|1101000|1110000|1111000|1101000|1111000|1011000
0101000|1111000|1100000|1111000|1111000|1110000|1011000
0111000|1011000|0101000|1111000|1111000|1001000|0011000
0110000|1111000|1111000|1011000|0111000|1111000|1011100
0100010|1110000|1110000|1110000|1110000|1110000|1010000
