0101000|1100000|1001000|0100000|1101000|1000010
0011000|0101000|1010000|0101000|1111000|1001010
0011000|0111000|1000000|0111000|1110000|1010000
0110000|1010010|0101000|1111000|1001000|0001000
0100100|1101000|1010000|0111001|1110000|1010000
0100000|1110000|1000000|0010000|0000000|0000000
