0001010|0100000|1101000|1101001|1001000
0111000|1000000|0110000|1010000|0011000
0110000|1100000|1001000|0101000|1011000
0001000|0101000|1011000|0011000|0011010
0110100|1010000|0110010|1110000|1010000
