0100010|1101000|1001000|0101000|1001100
0100000|1111000|1110000|1110000|1011000
0100000|1111000|1100000|1101000|1011000
0100000|1010000|0000000|0111010|1010000
0100000|1100001|1100000|1110010|1000000
