0100000|1100000|1100000|1101000|1001000|0000000|0001100
0101000|1100000|1001000|0010000|0011000|0101010|1010000
0110000|1101000|1110000|1100000|1111000|1011000|0001000
0101000|1011000|0101000|1001000|0110000|1010000|0011000
0110000|1011000|0110000|1110000|1101000|1100000|1010000
0100000|1111001|1001000|0001000|0110000|1001000|0001000
0100010|1010010|0010000|0110000|1000000|0110000|1010000
