0001010|0001000|0101001|1101000|1000010
0011000|0111000|1011000|0111000|1000000
0111000|1110000|1110000|1011000|0001000
0110010|1100000|1101000|1010000|0010000
0100000|1000000|0110000|1100000|1000100
