0101000|1000000|0100000|1101100|1101000|1001000
0111000|1101001|1101000|1011000|0111000|1011000
0111010|1010000|0011000|0110000|1111000|1011000
0111000|1101000|1111000|1100000|1110000|1011000
0110000|1110000|1110010|1001000|0001000|0011000
0100000|1100000|1100000|1110000|1110000|1010010
