0101000|1101000|1101000|1100010|1101000|1001010
0111000|1010000|0111000|1101000|1111000|1011000
0111000|1100000|1111000|1111000|1111000|1010000
0011001|0001000|0110000|1111000|1111000|1001000
0111000|1111000|1101000|1111000|1110000|1011000
0110010|1110000|1110000|1010000|0000000|0010100
