0100010|1101000|1101000|1101000|1101001|1000010
0101000|1110000|1110000|1111000|1111000|1001000
0111000|1101000|1100000|1111000|1111000|1011000
0010000|0111000|1100000|1111000|1111000|1011000
0101000|1111000|1101000|1111000|1011000|0011000
0110000|1010000|0110100|1110000|1010010|0010000
