0100000|1101000|1001000|0101000|1100000|1101001|1001000
0101000|1011000|0111000|1011000|0101010|1110000|1010010
0110000|1011000|0111000|1011000|0111000|1101000|1000000
0100000|1110000|1111000|1111000|1111000|1010000|0001000
0101000|1101000|1111000|1010000|0011000|0101000|1011000
0111100|1111000|1110000|1101000|1011000|0111000|1011000
0110000|1110000|1000000|0110010|1110000|1010000|0010000
