0100000|1100000|1101010|1001000|0001000
0100000|1101000|1110100|1111000|1011000
0001000|0010000|0001000|0011000|0011000
0011000|0101000|1111000|1111011|1011000
0110010|1110000|1010000|0010000|0010000
