0001000|0100100|1101000|1101000|1101000|1001010
0111000|1100000|1111000|1111000|1111000|1011000
0010000|0101000|1010000|0110000|1110000|1011000
0000000|0111000|1101000|1101000|1101000|1011000
0101010|1011000|0111000|1011000|0111000|1010001
0110000|1010000|0110000|1110000|1110000|1000010
