0101000|1100100|1101000|1100000|1000010
0111000|1100000|1011000|0001000|0001000
0011000|0101000|1111000|1011000|0010000
0111000|1111000|1111000|1111000|1001001
0010000|0110010|1110010|1110000|1010000
