0101010|1001000|0101001|1100000|1001010
0111000|1110000|1011000|0100000|1010000
0011000|0101000|1111000|1001000|0001000
0111000|1110000|1111000|1011000|0011000
0110100|1000000|0110000|1010010|0010000
