0101000|1001000|0100000|1101010|1101000|1001000
0111001|1010000|0101000|1110000|1011000|0010010
0111010|1101000|1111000|1001000|0110000|1001000
0011000|0010000|0011000|0010000|0001000|0011000
0110000|1101000|1111000|1000000|0010000|0011000
0100000|1110000|1010000|0100000|1100100|1010000
