0101000|1100000|1101000|1101000|1101000|1001100
0111000|1101000|1011000|0111000|1010000|0010000
0011000|0111010|1111000|1111000|1001000|0000000
0111000|1111000|1010010|0110000|1010000|0001000
0111000|1111000|1101000|1101000|1001000|0011000
0010000|0110000|1010000|0110001|1110000|1010010
