0001000|0101000|1001010|0101000|1001000
0111000|1011000|0111010|1111000|1010000
0011000|0111000|1111000|1010000|0001000
0110000|1111000|1111000|1100000|1011100
0100000|1110010|1010001|0000000|0010000
