0101010|1100000|1001100|0101000|1001000|0101000|1001000
0011000|0100000|1111000|1110000|1111000|1111000|1011000
0010000|0100000|1111000|1101000|1110000|1110000|1011000
0001000|0001000|0011000|0110000|1101000|1001000|0010000
0011000|0110000|1110000|1000000|0011000|0111000|1001000
0111000|1100000|1000000|0101000|1111000|1110000|1011010
0110000|1100000|1000000|0110000|1110000|1100011|1010000
