0001000|0100010|1101000|1101000|1101010|1000000
0111000|1101000|1111000|1011000|0011000|0001000
0111000|1111000|1011000|0111000|1111000|1010000
0111000|1111000|1011000|0010000|0110000|1001000
0011000|0110000|1011001|0101000|1101000|1010000
0110000|1000000|0110010|1010000|0110000|1000100
