0000000|0001000|0100000|1101010|1001000
0100000|1010000|0001000|0011000|0011000
0100000|1101000|1110000|1110000|1010000
0000000|0011001|0001000|0101000|1000010
0100100|1010010|0110000|1010000|0000000
