0100000|1101010|1101000|1101000|1001000
0101000|1110000|1111000|1110010|1010100
0111000|1101000|1111000|1001000|0000000
0110000|1110000|1111000|1011000|0001000
0100000|1100010|1010000|0110000|1010001
