0101000|1100000|1101000|1101000|1101000|1100000|1000010
0111000|1100000|1111000|1110000|1111000|1000000|0001000
0110000|1101000|1111000|1100000|1011000|0100000|1011000
0001000|0011000|0011001|0001000|0011000|0101000|1011000
0010010|0111000|1111000|1111000|1110000|1111000|1011100
0101000|1010000|0010000|0011000|0001000|0110000|1011000
0010000|0100000|1100010|1010000|0110000|1100000|1010000
