0101000|1101010|1000000|0101000|1101000|1100000|1001000
0110000|1110001|1001000|0110000|1010000|0100000|1011000
0101000|1101000|1111000|1101000|1101000|1100000|1011000
0110000|1111000|1111000|1110000|1011000|0001010|0011000
0101000|1011000|0110000|1100000|1011000|0111000|1010010
0111000|1111000|1101000|1001000|0110000|1111000|1001000
0110100|1110000|1110000|1110000|1100000|1110000|1010000
