0000000|0100000|1101000|1101000|1101000|1000010
0101000|1001000|0111000|1011000|0111000|1001010
0111000|1111000|1111000|1110000|1111000|1011000
0111000|1110000|1111000|1101000|1110000|1011000
0111000|1001000|0111000|1111001|1101000|1011000
0110100|1110010|1110000|1110000|1110000|1010000