0100100|1101010|1100000|1000000|0001000|0001000
0101000|1111000|1000000|0101000|1110000|1011001
0111000|1011000|0101000|1011000|0001000|0011000
0111000|1111000|1111000|1111000|1111000|1010000
0111000|1011000|0111000|1111010|1111000|1001000
0110000|1110000|1110000|1110000|1110000|1010010
