0101010|1100000|1101000|1101000|1000010
0110000|1101000|1111000|1010000|0001000
0001001|0011000|0111000|1100000|1011000
0011010|0111000|1011000|0101000|1011000
0110000|1010000|0110000|1110000|1010100
