0101000|1001000|0100010|1100000|1101000|1001000
0010000|0110000|1100000|1000000|0111100|1011000
0100000|1000000|0101000|1101000|1111000|1011000
0101000|1100000|1110000|1111000|1110000|1011000
0010011|0100000|1100000|1011000|0100000|1011000
0100000|1100000|1100000|1010010|0100000|1010000
