0100000|1100000|1000000|0101000|1100000|1101000|1001010
0101000|1100010|1101000|1111001|1101000|1111000|1011000
0011000|0100000|1011000|0110000|1110000|1011000|0010000
0110100|1001000|0111000|1001000|0101000|1111000|1000000
0101000|1111000|1111000|1111000|1011000|0111000|1001000
0111000|1111000|1111000|1010000|0111000|1111000|1011000
0110000|1110000|1110000|1100010|1110000|1010000|0010000
