0100000|1101000|1100000|1101000|1100000|1001100
0101000|1110010|1101000|1011000|0100000|1010010
0111000|1001000|0111000|1111000|1001000|0001000
0110000|1011000|0111000|1111000|1111000|1010000
0100000|1111000|1111001|1110000|1111000|1001000
0000000|0110010|1010000|0100000|1110000|1010000
