0001010|0100000|1101001|1100000|1000000
0011000|0001000|0011000|0101000|1001010
0111000|1011000|0111000|1110000|1010000
0011000|0111000|1111000|1100000|1001000
0110010|1110000|1110000|1100000|1010100
