0101000|1101010|1101000|1100001|1100000|1000000
0110000|1110000|1110000|1101000|1001000|0001000
0101000|1101000|1001000|0111000|1111000|1010000
0111000|1111000|1111010|1011000|0110000|1000000
0111000|1110000|1111000|1011000|0101000|1001000
0110000|1100000|1110000|1110000|1110010|1010100
