0101010|1001000|0100000|1000000|0001000
0111000|1111000|1000000|0001000|0011010
0110000|1111000|1101000|1111000|1010000
0100100|1110000|1111000|1111000|1001000
0000000|0100000|1010000|0110011|1010000
