0101010|1101000|1001001|0101000|1101000|1001000
0111000|1010000|0110000|1110000|1111000|1010100
0011000|0100000|1001000|0100000|1111000|1001000
0111000|1001000|0111000|1001000|0011000|0011000
0111010|1111000|1111000|1111000|1111000|1010000
0110000|1110010|1010000|0110000|1010000|0000000
