0101000|1001000|0101000|1000000|0101000|1001000|0001100
0010000|0111000|1011000|0101000|1110000|1111000|1011000
0101000|1110000|1011000|0111000|1100000|1111000|1010000
0011000|0100010|1011000|0111000|1100000|1111010|1001000
0011000|0101000|1010000|0110000|1001000|0111000|1011000
0111000|1111000|1100001|1101000|1011000|0110000|1010000
0010000|0010010|0100000|1110000|1010000|0100000|1000000
