0000000|0101000|1100000|1101000|1100000|1000000
0000000|0111000|1100000|1010000|0101011|1001000
0101000|1111000|1001000|0101000|1110000|1011010
0011010|0011000|0010000|0110000|1100000|1011000
0010000|0111000|1101000|1101000|1101000|1011000
0100100|1110000|1110000|1010000|0010000|0010000
