0101000|1001000|0100100|1101000|1001000
0111000|1111000|1101000|1111000|1010000
0111010|1111000|1111001|1111000|1001010
0111000|1110010|1011000|0110000|1011000
0110000|1000000|0010000|0100000|1010000
