0101000|1101000|1100011|1001000|0001000
0111000|1110000|1100000|1011000|0011000
0011000|0101000|1101000|1011010|0011000
0011010|0110000|1111000|1011000|0010000
0010000|0100000|1010000|0110000|1000100
