0101010|1101000|1101000|1101000|1000100
0011000|0110000|1111000|1111000|1001000
0111000|1100000|1111000|1110000|1011000
0111001|1100000|1111000|1001000|0010000
0110010|1100000|1010000|0110000|1000010
