0101010|1100001|1001010|0001000|0001000
0111000|1100000|1010000|0010000|0011000
0110000|1100000|1001000|0100000|1010000
0101010|1100000|1111000|1100000|1001100
0110000|1000000|0110000|1100000|1010000
