0101010|1100000|1001000|0101000|1001010
0110000|1000100|0111000|1010000|0011000
0101000|1101000|1010000|0101000|1010000
0111000|1111000|1101000|1110000|1001000
0110010|1010000|0110000|1100000|1010001
