0101010|1100000|1101000|1001000|0100000|1101000|1001000
0110000|1101000|1111000|1110000|1101000|1010000|0010100
0100000|1110000|1111000|1000000|0111000|1100000|1001000
0101000|1100000|1111000|1101000|1110000|1101000|1011000
0111000|1100000|1010000|0111000|1001000|0111000|1010000
0111000|1001001|0100000|1111000|1111000|1111000|1001000
0110000|1110000|1100010|1010000|0110000|1110010|1010000
