0101000|1001010|0101000|1101000|1001000
0011000|0111000|1110000|1110000|1010000
0111000|1111010|1101000|1100000|1001000
0110100|1010000|0111001|1101000|1011000
0100000|1100000|1110000|1110010|1010000
