0101000|1001000|0101000|1101000|1101010|1001000
0011000|0110000|1111000|1011000|0111000|1010000
0111100|1001000|0111000|1111000|1010000|0001000
0011000|0111000|1010000|0111000|1101000|1011000
0111000|1110000|1000000|0111000|1010000|0011001
0110010|1000000|0000000|0110000|1100000|1010010
