0101000|1101000|1101000|1101000|1001010
0011010|0111000|1110000|1111000|1011001
0111000|1111000|1101010|1110000|1011000
0011000|0011000|0111000|1101000|1011000
0010000|0010100|0010000|0110000|1010000
