0101010|1100000|1100001|1101000|1001000|0101000|1001010
0111000|1001000|0101000|1110000|1010000|0110000|1011000
0111000|1111000|1011000|0101000|1101000|1001000|0011000
0011000|0011000|0111000|1011000|0011000|0111000|1011000
0011000|0111000|1110000|1010000|0110000|1011000|0011000
0111000|1011000|0101000|1000000|0101000|1110000|1011000
0110000|1110000|1110000|1100010|1110000|1100000|1010100
