0001100|0101000|1101000|1001000|0001000|0001000
0111000|1111000|1011000|0111000|1111000|1011010
0111000|1111000|1111000|1011000|0011000|0011000
0011000|0110000|1111000|1111000|1111000|1010001
0111000|1100000|1110000|1111000|1111000|1000010
0110010|1100000|1100000|1010000|0110000|1000000
