0101010|1001000|0001000|0101000|1001100
0110000|1111000|1111000|1111000|1010000
0001001|0111000|1111000|1110000|1000000
0111000|1111000|1110000|1101000|1000000
0010010|0010000|0100000|1110010|1000000
