0101000|1101000|1001000|0101000|1001011
0111000|1111000|1111000|1111000|1011000
0110100|1111000|1111010|1110000|1011000
0100000|1011000|0111000|1101000|1011000
0100010|1110000|1110000|1110000|1010000
