0101000|1100000|1101000|1101000|1001000|0001010
0110100|1000000|0111000|1110000|1111000|1010000
0001000|0001000|0111000|1100000|1111000|1001000
0011000|0111000|1110000|1100000|1110000|1010000
0011000|0011000|0101000|1101000|1100001|1001000
0110000|1110010|1110000|1110000|1000010|0010000
