0101010|1000000|0001000|0101010|1101000|1001000
0111000|1101000|1111000|1011000|0111000|1011000
0111000|1011001|0111000|1111000|1011000|0011000
0011000|0111000|1111000|1111000|1111000|1011000
0111010|1111000|1111000|1011000|0011000|0011000
0110000|1110000|1110000|1110000|1010000|0010100
