0101000|1101000|1001000|0101010|1100000|1001000
0111000|1010000|0010000|0111000|1101000|1011010
0110010|1100000|1100000|1011000|0110000|1011001
0101000|1001000|0001000|0111000|1101000|1011000
0011100|0111000|1011000|0111000|1010000|0011000
0110000|1110000|1110000|1110000|1100000|1010000
