0001010|0100000|1101000|1101000|1000000
0111001|1101000|1111000|1011000|0001000
0111000|1110000|1111000|1110000|1011000
0111000|1101000|1011010|0101000|1011100
0110000|1110000|1110000|1110000|1010010
