0001010|0000000|0001000|0001001|0101000|1000000
0011000|0101000|1111000|1111000|1111000|1000010
0111000|1011000|0110000|1011000|0110000|1001000
0111000|1110000|1100000|1011000|0101000|1010000
0111000|1101000|1001000|0011000|0011000|0001000
0110100|1110000|1110000|1010000|0010010|0010000
