0001011|0100000|1100000|1101000|1101000|1101000|1000000
0110000|1001000|0101000|1110000|1011000|0011000|0001000
0101010|1110000|1011000|0100000|1011000|0111000|1010000
0111000|1000000|0111000|1001000|0011000|0111000|1001000
0111000|1101000|1110010|1111000|1111000|1110000|1011000
0111000|1111000|1101000|1110000|1111000|1101000|1011000
0110000|1010000|0110000|1100000|1010000|0110000|1010100
