0100010|1101000|1001000|0101000|1100000|1000000
0101000|1111000|1011000|0111000|1101000|1000100
0111000|1111000|1111000|1111000|1010000|0001000
0011000|0111000|1010000|0110000|1100000|1011000
0111010|1111000|1101000|1101000|1100000|1011000
0110000|1010001|0010000|0110000|1100000|1010010
