0001000|0000000|0101010|1001000|0101000|1000010|0001000
0011000|0101010|1011000|0011000|0011000|0101000|1010000
0011000|0011001|0111000|1011000|0110000|1111000|1000000
0111000|1111000|1111000|1011000|0100000|1110000|1001000
0110000|1011000|0111000|1111000|1101000|1101000|1010000
0001000|0111000|1010000|0111000|1011000|0111000|1001000
0010000|0110000|1000000|0010000|0110000|1110000|1010100
