0101011|1001000|0101000|1101000|1001000|0101000|1001000
0111000|1110000|1111000|1111000|1111000|1111000|1011000
0111000|1101000|1110000|1111000|1111000|1111000|1011000
0010000|0011000|0001000|0111000|1010000|0111000|1011000
0101000|1010000|0110000|1111000|1100010|1110000|1011000
0111000|1001000|0101000|1010000|0101000|1101100|1011000
0010010|0110000|1110000|1100000|1110000|1110000|1010000
