0101000|1101000|1001001|0001000|0001010
0111010|1111000|1110000|1110000|1011000
0010000|0110000|1100000|1001000|0011000
0101000|1101000|1101000|1111000|1011000
0110010|1110000|1110000|1010000|0010100
