0100000|1101000|1000000|0001000|0001000|0001100
0101000|1110000|1101000|1010000|0111000|1011000
0111010|1001000|0111000|1100000|1011000|0011000
0110000|1010000|0111000|1100000|1010000|0011000
0101000|1100000|1110000|1001000|0100000|1010000
0110000|1000010|0100000|1110001|1100000|1000010
