0100100|1101000|1100000|1001000|0101000|1001000|0001000
0101000|1111000|1101000|1011000|0111000|1111000|1010000
0111000|1111000|1111000|1111000|1111000|1111000|1000000
0111000|1110000|1111000|1011000|0011000|0011000|0001010
0111000|1000000|0111000|1111010|1111000|1011000|0010010
0111000|1101001|1011000|0111000|1010000|0110000|1000000
0110000|1010000|0010000|0110000|1100000|1000000|0000000
