0001100|0101000|1101000|1001000|0001010
0111000|1011000|0011000|0011000|0011000
0111000|1011000|0110000|1111000|1011000
0111000|1011000|0001000|0011000|0011000
0010010|0010000|0010000|0010001|0010010
