0101100|1101000|1101000|1100000|1100000|1001000
0011000|0110000|1111000|1000000|0101000|1010000
0111010|1101000|1110000|1101000|1111000|1001001
0111000|1010000|0001000|0110000|1111000|1011000
0111000|1100000|1110000|1100000|1111000|1011000
0110000|1100000|1000000|0100000|1110010|1010010
