0100000|1101010|1101001|1001000|0100000|1000000|0001000
0101000|1011000|0111000|1011000|0100000|1001000|0011000
0110010|1010000|0111000|1011000|0101000|1110000|1011000
0001000|0001000|0010000|0111000|1011000|0101000|1011000
0111000|1110010|1100000|1010000|0010000|0011000|0011000
0110000|1100000|1001000|0101000|1101000|1110000|1011000
0100000|1000000|0110000|1110000|1110000|1100000|1010100
