0100001|1001010|0101000|1101000|1001000
0101000|1111000|1110000|1011000|0011010
0111010|1111000|1101000|1110000|1011000
0111000|1110000|1011000|0101000|1010000
0110000|1100000|1010000|0110000|1000100
