0001010|0101000|1001000|0100000|1001100
0111000|1111000|1111000|1101000|1010000
0110001|1011000|0010000|0011000|0001000
0100000|1011000|0101000|1111000|1010000
0100000|1010010|0110000|1110000|1000010
