0100000|1100000|1100010|1001000|0001000|0000000
0100001|1101000|1100000|1111000|1111000|1000000
0101000|1110000|1101000|1110000|1111000|1001000
0111000|1101000|1010000|0001000|0111000|1011100
0111000|1111010|1101000|1111000|1111000|1011000
0110000|1010000|0110000|1110000|1110000|1010010
