0101000|1001000|0101000|1101000|1100000|1001000|0001010
0111000|1111000|1110010|1111000|1101000|1111000|1011100
0111000|1111000|1100000|1110000|1111000|1010000|0011000
0111000|1111000|1100000|1101000|1011000|0100000|1011000
0110001|1110000|1100000|1110000|1010000|0101000|1010000
0101010|1100000|1001000|0101000|1101000|1111000|1000000
0110000|1100000|1110000|1010000|0110000|1110000|1000000
