0100000|1000000|0100000|1001000|0001000
0101100|1100010|1100000|1111000|1011001
0011000|0001000|0101000|1111010|1011000
0111000|1111000|1111000|1110000|1011000
0110000|1110000|1010000|0100000|1010010
