0001010|0001000|0101000|1100000|1001010
0111001|1011000|0111000|1001000|0011000
0110000|1011000|0110000|1111000|1011000
0101000|1111000|1100000|1111000|1011100
0010010|0110000|1100000|1110000|1010000
