0100100|1100000|1101000|1100000|1101000|1000000
0101000|1100010|1110000|1001000|0111000|1001010
0111000|1000000|0101000|1111000|1110000|1011000
0110000|1101000|1111000|1111000|1100000|1011000
0101000|1110000|1111000|1010001|0100000|1011010
0110000|1100000|1110000|1000000|0100000|1010000
