0001000|0100000|1100000|1000000|0101000|1001010
0111000|1101000|1101000|1100000|1111000|1011000
0010010|0111000|1110000|1101000|1111000|1011000
0101000|1011000|0101000|1111000|1111000|1010001
0011000|0111000|1011000|0111000|1111000|1001010
0110100|1010000|0110000|1110000|1110000|1010000
