0100000|1100000|1101000|1101000|1101010|1001000
0101000|1001000|0011000|0011000|0111000|1011000
0111000|1011100|0010000|0111000|1111000|1011000
0110000|1011000|0000000|0011000|0111000|1010000
0101000|1011000|0101000|1011010|0110000|1001000
0110010|1110000|1010000|0010000|0000000|0010001
