0101000|1001000|0100000|1001000|0100010|1100000|1001000
0111000|1111000|1100000|1111000|1100000|1101000|1010000
0111000|1110000|1001000|0110000|1101000|1111001|1001000
0011000|0101000|1110000|1001000|0110000|1111010|1010000
0011000|0111000|1101000|1011000|0000000|0111000|1000100
0110000|1110000|1011000|0110000|1100000|1111000|1001000
0100010|1000000|0010000|0100000|1100000|1110000|1010000
