0001000|0101010|1101001|1101000|1000010
0010000|0111000|1111000|1110000|1000000
0101000|1010000|0111000|1101000|1001000
0110000|1101000|1111000|1111000|1010000
0100010|1010000|0010000|0110000|1000100
