0001010|0101000|1101001|1100000|1101000|1101000|1000000
0111000|1011010|0010000|0001000|0010000|0111000|1001000
0011000|0010000|0100000|1011000|0001000|0110000|1011000
0111000|1000000|0001000|0010000|0111000|1101000|1011000
0111000|1001000|0110000|1101000|1111000|1111000|1011000
0011000|0011000|0100000|1110000|1111000|1110000|1011000
0110000|1110000|1100000|1000000|0110000|1000010|0010100
