0100010|1001000|0101000|1101000|1001010
0100001|1111000|1010000|0011000|0011000
0100000|1111000|1000000|0111000|1010000
0101000|1010000|0101000|1111000|1001100
0110010|1100000|1010000|0110000|1010000
