0001000|0100000|1001000|0101000|1101000|1000010
0011000|0101010|1110000|1110000|1111000|1001100
0111000|1110000|1100000|1101000|1111000|1011000
0111000|1101000|1100000|1110000|1110000|1011000
0010010|0110001|1001000|0101000|1101000|1010000
0100000|1000000|0110000|1010000|0110000|1000000
