0101010|1000000|0001001|0101000|1000000
0111000|1100000|1110000|1111000|1001010
0111000|1001000|0101000|1011000|0011000
0111000|1110000|1111000|1111000|1011000
0010100|0000000|0010000|0110000|1010010
