0101000|1100000|1101000|1101000|1100000|1101010|1000100
0110000|1101000|1111000|1110000|1001000|0011000|0000000
0101000|1110000|1111000|1101000|1110000|1110000|1000000
0110000|1101000|1110000|1110000|1001000|0100000|1001000
0101010|1111000|1100000|1100000|1111000|1001000|0011000
0011000|0011000|0100001|1101000|1111000|1110000|1010000
0110000|1110010|1100000|1110000|1010000|0100000|1000000
