0100000|1101000|1101000|1101000|1101000|1001010
0100000|1111000|1010000|0010000|0011010|0011000
0100000|1111000|1000100|0100000|1110000|1011001
0001000|0010000|0101000|1001000|0100000|1010000
0111000|1100000|1110000|1111000|1101000|1001000
0110010|1100000|1100000|1110000|1110000|1010000
