0100000|1101000|1100010|1101000|1001100
0100000|1110000|1101000|1110000|1011000
0101001|1101000|1111000|1000000|0011000
0110000|1111010|1110000|1100000|1011000
0100000|1110000|1100000|1100000|1010010
