0001000|0100000|1101000|1101000|1100000|1100000|1001000
0011000|0101000|1111000|1111000|1001000|0000000|0011010
0111000|1111000|1011000|0111000|1110000|1101000|1010000
0010000|0111000|1111000|1010000|0101010|1111000|1001100
0100000|1011000|0111000|1101000|1011000|0111000|1011000
0001000|0111001|1111000|1110000|1011000|0011000|0011000
0010010|0110000|1110000|1100000|1110000|1110000|1010000
