0101010|1101000|1000000|0001000|0001000|0100000|1000000
0111000|1111000|1101000|1111000|1111000|1101100|1001000
0011000|0111000|1010000|0111000|1010000|0111000|1010000
0111000|1011000|0100000|1111000|1100000|1111000|1001000
0111000|1110000|1101000|1111000|1101000|1011000|0011000
0111001|1101000|1011000|0111000|1011000|0110000|1010010
0110000|1010010|0110000|1110000|1010000|0100000|1000000
