0101010|1101000|1100000|1101000|1001000
0111000|1111100|1100000|1111000|1011000
0111000|1111000|1101000|1110000|1011001
0011010|0111000|1111000|1101000|1011000
0110000|1110000|1110000|1110010|1010000
