0001100|0001000|0100000|1101000|1000010
0111000|1111000|1101000|1110000|1001000
0011000|0011000|0111000|1100000|1010000
0011010|0111000|1110000|1101001|1000000
0110000|1110000|1100000|1110000|1000010
