0101000|1101100|1101000|1100000|1001000|0001001
0110010|1110000|1011000|0000000|0110000|1011000
0000000|0001000|0110000|1101000|1101000|1011000
0101000|1111000|1000000|0111000|1111000|1011000
0111000|1011000|0000000|0111010|1111000|1011000
0010000|0110000|1100010|1010000|0110000|1010000
