0100000|1101000|1000000|0001000|0101000|1001010
0101000|1111000|1101000|1111000|1010000|0011001
0110000|1010000|0011010|0111000|1101000|1010000
0001010|0101000|1011000|0011000|0011000|0001000
0111000|1011000|0011000|0110000|1010000|0010000
0110000|1010100|0110000|1100000|1100000|1000000
