0100000|1100010|1100000|1101000|1000010
0101000|1101000|1100000|1010000|0001000
0111000|1111000|1101000|1100000|1011001
0011000|0111000|1011000|0001000|0011000
0010100|0110000|1110000|1010000|0010010
