0100000|1001000|0001010|0101000|1001000|0100000|1000000
0101010|1110000|1011000|0110000|1111000|1101000|1001000
0011000|0100000|1111000|1100000|1110000|1111000|1011000
0111001|1101000|1111000|1101000|1101000|1110000|1010000
0110000|1111000|1010000|0111000|1111000|1001000|0001000
0001000|0111000|1100000|1111000|1111000|1110000|1011010
0010000|0110000|1100000|1110000|1010000|0000000|0010100
