0101000|1001000|0101010|1101000|1001000
0011010|0111000|1110001|1010000|0011100
0111000|1011000|0001000|0101000|1011000
0111000|1111000|1011000|0110010|1011000
0110000|1110000|1010000|0100000|1010000
