0101000|1101000|1001001|0101000|1000010
0111010|1111000|1110000|1110000|1001000
0111000|1110000|1100000|1000000|0011000
0110000|1101000|1101000|1101000|1011000
0100100|1010000|0110000|1110000|1010010
