0100010|1101000|1001001|0001000|0001000
0001000|0110000|1110000|1111000|1011010
0110000|1001000|0101000|1111000|1011000
0000000|0111000|1010000|0011000|0011000
0100100|1110000|1100000|1010000|0010010
