0101100|1100000|1101000|1101010|1001000|0001000
0111000|1100000|1111000|1111000|1110000|1010010
0111000|1001000|0111000|1010000|0100000|1001000
0111000|1111000|1110000|1101000|1000000|0011001
0010000|0111000|1101000|1111000|1101000|1011000
0100000|1110000|1110000|1110000|1110010|1010000
