0100010|1101000|1100000|1000000|0100000|1001000
0001000|0111000|1101010|1001000|0001000|0011000
0110000|1011000|0111000|1111000|1110000|1011000
0101000|1110100|1111000|1011000|0100000|1010000
0111000|1000000|0011000|0011000|0100000|1000000
0110001|1000000|0110000|1010000|0100000|1000010
