0100000|1101000|1100000|1001010|0001001
0001000|0011100|0100000|1111000|1010000
0111000|1111010|1000000|0111000|1001000
0111000|1110000|1101000|1111000|1011000
0110000|1000000|0110000|1110000|1010010
