0101010|1101000|1100000|1101000|1001000|0000000
0111000|1111000|1100000|1111000|1011000|0001000
0111010|1111001|1101000|1010000|0111000|1011000
0111000|1111000|1111000|1000000|0111000|1011000
0110000|1111000|1011000|0101000|1110000|1011000
0100000|1110000|1110000|1010000|0100010|1010100
