0101000|1100010|1001000|0001000|0001000|0101100|1001000
0111000|1100000|1011000|0111000|1111000|1111000|1011000
0111000|1001000|0110000|1111000|1011000|0111000|1010000
0111000|1111000|1001000|0011000|0110000|1111010|1001000
0011001|0111000|1011000|0111000|1101000|1110000|1011000
0111000|1010000|0110000|1110000|1010000|0101000|1011000
0010000|0100010|1100000|1100000|1100000|1110000|1010000
