0100000|1101000|1101000|1001000|0100000|1101010|1001000
0001000|0111010|1110000|1111000|1101000|1110000|1010000
0011000|0011000|0101000|1111000|1111000|1100001|1000000
0011000|0110000|1111000|1111000|1110000|1100000|1000000
0010000|0101000|1110000|1111000|1100000|1101000|1001000
0001000|0011000|0101000|1111000|1101000|1111000|1010010
0110100|1010000|0110000|1110000|1110000|1110000|1000000
