0001000|0001010|0101000|1001000|0101000|1101000|1001000
0111000|1111000|1111000|1011000|0011000|0110000|1011000
0110100|1111000|1011000|0111000|1111000|1001000|0011000
0000000|0010000|0111000|1011000|0110000|1011000|0011000
0001000|0001000|0110000|1111000|1001000|0011000|0010000
0111000|1111000|1001000|0111000|1111000|1011000|0001010
0110000|1110000|1010000|0110000|1110000|1110001|1010010
