0101100|1100000|1001000|0001000|0001010
0111000|1101000|1111000|1110000|1011000
0010000|0111000|1111000|1101000|1010000
0101000|1011000|0110000|1111001|1000010
0110010|1110000|1100000|1110000|1000000
