0000000|0001100|0100000|1101000|1001000|0000000
0101000|1011000|0101000|1011000|0111000|1001010
0011000|0111000|1110000|1011001|0111000|1010000
0111000|1111000|1001000|0011000|0111000|1001000
0010000|0111000|1111000|1111000|1111000|1010000
0000000|0010010|0110000|1110000|1010010|0000000
