0101000|1101010|1000000|0101001|1001000|0001000
0111000|1111000|1101000|1111000|1011000|0011000
0111000|1110000|1110000|1111000|1111000|1010010
0111000|1101000|1101000|1010000|0011000|0001000
0010000|0111000|1010000|0101000|1111000|1011000
0100010|1110000|1000000|0110000|1110000|1010100
