0101000|1101000|1101000|1000000|0100000|1000000
0111000|1111000|1111000|1100000|1100000|1001000
0110010|1111000|1111000|1101000|1000000|0011100
0000000|0110000|1010000|0111000|1101000|1011000
0101001|1101000|1101000|1011000|0110000|1011000
0010000|0110010|1010000|0110000|1000000|0010010
