0000000|0101000|1101000|1101000|1000000
0101000|1110010|1011000|0110000|1001100
0011000|0101000|1011000|0101000|1011000
0111010|1111000|1111000|1111000|1011010
0110000|1110000|1110000|1010000|0010001
