0101000|1001010|0101000|1101000|1000010
0111000|1010001|0111000|1110000|1000000
0111000|1100000|1110000|1101000|1001000
0111000|1101000|1100000|1010000|0011000
0110010|1110000|1100000|1100000|1010100
