0101000|1101000|1101000|1001000|0001010
0110100|1111000|1111000|1111000|1011000
0101000|1011000|0110000|1111000|1010000
0111000|1111000|1001000|0111000|1001001
0010010|0110000|1110000|1110000|1010010
