0100000|1101000|1101100|1100000|1001000|0101000|1000010
0101000|1111000|1111000|1101000|1111000|1111000|1000000
0111000|1111000|1011000|0110000|1011000|0111000|1001000
0011000|0111000|1011000|0101000|1111000|1111000|1011000
0011000|0111010|1111000|1011000|0011000|0110000|1011000
0110000|1011000|0010000|0110000|1111000|1000000|0011000
0100000|1110010|1100000|1000000|0010000|0100000|1010001
