0100010|1101001|1001000|0001000|0101000|1000000
0100000|1010000|0110010|1011000|0011000|0001000
0100000|1101000|1001000|0110000|1011000|0011100
0101000|1010000|0011000|0101000|1011000|0011000
0111000|1101000|1110000|1111000|1011010|0010000
0110000|1110000|1100000|1110000|1110000|1000000
