0001100|0101000|1100000|1101000|1101000|1000010
0111000|1110000|1101000|1011000|0110000|1001000
0111000|1101000|1111000|1011000|0001000|0011000
0110000|1111000|1111000|1111000|1011000|0011000
0101000|1110000|1111010|1111000|1111000|1011000
0110000|1000000|0110001|1010000|0010000|0010010
