0100010|1101000|1101000|1101000|1001100
0101000|1111000|1111000|1111000|1011000
0111000|1111000|1110000|1010000|0011000
0111010|1110001|1101000|1101000|1010000
0110000|1100000|1110000|1110000|1000010
