0101000|1100000|1100000|1100000|1101000|1001000
0111010|1101000|1101000|1000100|0111000|1011010
0111000|1110000|1111000|1001000|0110000|1011000
0111000|1101000|1110000|1111000|1000000|0010000
0011000|0110000|1001000|0111000|1000000|0001000
0110000|1100010|1010000|0110000|1000001|0010000
