0001010|0101000|1101000|1101100|1001000
0110000|1111000|1011000|0011000|0011000
0101000|1111000|1011000|0110000|1010000
0111001|1111000|1110000|1001000|0001000
0010010|0110000|1100000|1110000|1010010
