0101100|1101000|1101000|1101000|1000000|0101000|1000000
0111010|1111000|1111000|1111000|1101000|1011000|0001000
0111000|1010000|0111000|1111000|1111000|1111000|1010000
0111000|1101000|1111000|1011000|0111000|1111000|1001000
0011000|0011000|0110000|1111000|1011000|0011000|0011000
0111000|1111000|1001000|0110000|1111010|1110011|1011000
0110000|1010000|0110000|1000000|0110000|1000000|0010000
