0101010|1001000|0101000|1101000|1001000|0001000|0001000
0111100|1110000|1111000|1111000|1111000|1011000|0011000
0011000|0101000|1011000|0111000|1011000|0011000|0010000
0011000|0011000|0010000|0011000|0011000|0111000|1001000
0110000|1111000|1000000|0111000|1111000|1110000|1011010
0100000|1010000|0000000|0110000|1110000|1100001|1011000
0100000|1000000|0100000|1100000|1100000|1100010|1010000
