0101000|1001100|0101000|1100000|1001000
0011000|0011000|0111000|1101000|1011000
0111000|1111000|1111000|1011000|0011000
0111000|1011000|0111000|1111000|1011010
0110010|1110000|1110010|1110001|1010000
