0101000|1101000|1100000|1101000|1101000|1101010|1001000
0110000|1110000|1001000|0111000|1111000|1011000|0011010
0101000|1100000|1111000|1111000|1010000|0110000|1011000
0011000|0101000|1011001|0111000|1001000|0101000|1011000
0111000|1110000|1110000|1111000|1011000|0010000|0011000
0111000|1100000|1101000|1111000|1010000|0100000|1011000
0110000|1100100|1010000|0110000|1000000|0100000|1010010
