0101010|1101000|1101000|1001000|0000000
0110000|1111000|1111010|1111000|1001000
0001000|0111000|1011000|0110000|1011000
0111000|1111001|1110000|1001000|0011000
0110000|1110000|1100100|1110000|1010010
