0101100|1101000|1101000|1001000|0101000|1001000
0010000|0111000|1111000|1110000|1110000|1010010
0101000|1110000|1011000|0100000|1101000|1001000
0110000|1101000|1111000|1000000|0010000|0010000
0100000|1111000|1111000|1001001|0100000|1001000
0000000|0110010|1110000|1110000|1000010|0010000
