0101000|1101000|1001000|0101000|1101000|1101000|1001000
0110000|1111001|1110000|1111000|1110100|1111000|1011000
0000000|0111000|1100000|1011000|0001000|0011000|0011000
0101000|1110000|1101010|1111000|1011000|0111000|1011000
0110000|1101000|1011000|0111000|1010000|0111000|1011000
0101000|1111000|1111000|1011000|0100000|1110000|1011000
0010000|0010000|0110000|1110010|1000000|0100000|1010010
