0001010|0000000|0001000|0001000|0101000|1101000|1001100
0111000|1001000|0011000|0111000|1111000|1111000|1011000
0110000|1111000|1011000|0111000|1110000|1011000|0011000
0101000|1111000|1011000|0111000|1100000|1011000|0010000
0111001|1011000|0010000|0010000|0101000|1010000|0001000
0111000|1111000|1001000|0101000|1111010|1101000|1010000
0110010|1010000|0110000|1110000|1010000|0110000|1000000
