0101000|1101010|1000000|0101000|1101000|1001000|0001000
0011000|0111000|1101000|1010000|0111000|1111000|1011000
0111000|1111000|1111000|1101000|1111000|1110000|1011100
0010000|0111000|1011000|0111000|1011000|0100000|1010000
0100000|1111000|1011000|0111000|1111000|1100000|1001000
0101000|1011000|0111000|1110000|1111000|1001000|0011000
0110011|1110000|1010000|0000000|0110000|1110000|1010010
