0101000|1101000|1101000|1100100|1100000|1000000
0111000|1010000|0011000|0100000|1001010|0001000
0011000|0000000|0111000|1001000|0111000|1011000
0011000|0001000|0111000|1110000|1111000|1010000
0111000|1111000|1111000|1101000|1111000|1001000
0010010|0110001|1110000|1110010|1110000|1010000
