0101000|1001000|0000000|0101000|1101100|1001000|0001000
0111010|1111000|1100000|1111000|1010000|0111000|1011000
0011000|0010000|0001000|0011001|0101000|1011000|0011000
0010000|0101000|1110000|1111000|1010000|0010000|0011000
0101000|1111000|1101000|1011000|0100000|1101000|1011010
0110000|1111000|1011010|0111000|1001000|0010000|0010000
0100000|1110000|1010000|0110000|1110000|1100000|1000000
