0101100|1100000|1001000|0100000|1000000
0111000|1001010|0110000|1100000|1001000
0111000|1011000|0100000|1101000|1011010
0111000|1010000|0101000|1110000|1011000
0110000|1100000|1110011|1100000|1010000
