0001000|0100000|1100000|1100010|1101000|1001000|0001000
0111000|1101100|1001000|0100000|1111000|1111000|1011000
0110000|1011000|0110000|1100000|1111000|1111000|1011000
0100000|1111000|1101000|1101000|1010000|0111000|1011000
0101000|1110000|1111000|1110000|1101000|1111000|1011000
0111000|1101000|1111010|1101000|1111000|1111000|1011010
0110000|1110000|1010000|0010001|0110000|1110000|1010000
