0001010|0101000|1001001|0101000|1101010|1101000|1000000
0111000|1110000|1110000|1111000|1111000|1111000|1001000
0110000|1001000|0101000|1111000|1011000|0111000|1010000
0101000|1110000|1010000|0111000|1110000|1111000|1001000
0111000|1101000|1101000|1110000|1001000|0111000|1011000
0011000|0011000|0111000|1001000|0111000|1111000|1010100
0110000|1110010|1010000|0010000|0110000|1110000|1000000
