0101100|1101000|1101000|1100000|1101000|1000010
0011000|0110000|1011000|0101000|1010000|0001000
0011000|0101000|1011000|0011000|0101000|1011000
0111000|1011000|0011000|0111000|1111000|1010000
0111000|1111000|1111000|1110001|1111000|1001000
0110010|1010000|0110010|1100000|1010000|0010000
