0001000|0101010|1001000|0101000|1100000|1101000|1001000
0010000|0110000|1111000|1011000|0101000|1111000|1010000
0001000|0100000|1111000|1111000|1011000|0111000|1001100
0110000|1101000|1110000|1011000|0111000|1110000|1011010
0100000|1011000|0101000|1110000|1111000|1100000|1010000
0101000|1110000|1110000|1100000|1111000|1100000|1001000
0010001|0100000|1100010|1100000|1110000|1000000|0010000
