0100000|1101001|1100010|1101000|1001000
0001010|0111000|1001000|0111000|1010000
0110000|1111000|1111000|1111000|1000000
0101000|1111000|1011000|0011000|0000000
0010010|0110000|1010000|0110100|1000000
