0101000|1101010|1100000|1001000|0100000|1001000|0001100
0110000|1111000|1001000|0110000|1101000|1111000|1011000
0101000|1110000|1111000|1101010|1110000|1111000|1010000
0111000|1101000|1110000|1111000|1101000|1111000|1001000
0110001|1111000|1100000|1111000|1111000|1111000|1010000
0100000|1111000|1100000|1110000|1111000|1111000|1001000
0100000|1110000|1100000|1100000|1110000|1110000|1010010
