0100000|1101000|1100000|1101000|1001010
0100100|1110000|1001000|0111000|1011000
0101000|1101000|1111000|1110000|1011000
0110000|1111000|1011000|0101000|1011000
0100010|1110000|1110000|1010001|0010010
