0101010|1000000|0001100|0101000|1101000|1001000|0001000
0111000|1001000|0111000|1110000|1111000|1010000|0010000
0111000|1110000|1110000|1101000|1111000|1100000|1000000
0111000|1001000|0101000|1111000|1110000|1101000|1001000
0111000|1010000|0111000|1111000|1001000|0011000|0011010
0111000|1101000|1111000|1010000|0011000|0111000|1011000
0010000|0010000|0010000|0100000|1110000|1010001|0010010
