0101010|1101000|1101000|1101000|1100000|1001100
0011000|0111000|1011000|0111000|1100000|1011000
0111000|1011000|0110000|1111000|1100000|1011000
0110000|1110001|1100000|1111000|1100000|1011000
0101000|1101000|1101000|1111000|1101000|1011000
0110010|1010000|0110010|1110000|1110000|1010000
