0001000|0101000|1101000|1101000|1000100
0111010|1110000|1111000|1010000|0001000
0110000|1101000|1111000|1101000|1011000
0001000|0111000|1011000|0110010|1011000
0110000|1110000|1110001|1100010|1010000
