0101000|1101000|1001001|0100000|1001000
0111000|1111010|1111000|1000000|0010000
0111000|1011000|0110000|1101000|1001010
0011000|0111000|1001000|0111000|1011000
0110010|1110000|1110000|1110000|1010100
