0101100|1001000|0101000|1101000|1001000
0111000|1111000|1110000|1110000|1011010
0011000|0110000|1101000|1001000|0011000
0011000|0001000|0011000|0011001|0010000
0110010|1010000|0110000|1110000|1000010
